NO ./textures/bricks.xpm
SO ./textures/LavaF3.xpm
WE ./textures/Ice.xpm
EA ./textures/Iron.xpm
C 164,239,230
F 178,177,146


1111111111
1000S00001
1000110001
1000110001
1000000001
1111111111
