NO ./textures/pierre.xpm
SO ./textures/rockwall.xpm
WE ./textures/brique.xpm
EA ./textures/cailloux.xpm
C 164,239,230
F 178,177,146

11111111111111111111111111
10000000000000000000000001
10000000000000000000000001
10000000000010000000000001
10000000000101000000000001
10000000000000000000000001
10000000000000000000000001
100000000000S0000000000001
11111111111111111111111111
