NO ./textures/pierre.xpm
SO ./textures/rowall.xpm
WE ./textures/brique.xpm
EA ./textures/cailloux.xpm
C 164,239,230
F 178,177,146


11111111111111111111111111111
10000000S011000001  100000001
1011000001110000011100000001
10010000000000000000000011111111
111111111011000001110000000000001
100000000011000001110111111111111
11110111111111011100000010001
11110111111111011101010010001   
110000001101010    11100000010001
10000000000000001100000010001   
10000000000000001101010010001
1100000111010101111101111000111
11110111 1110101 101111010001
11111111 1111111 111111111111