NO ./path_to_the_north_texture
SO ./path_to_the_south_texture
WE ./path_to_the_west_texture
EA ./path_to_the_east_texture
C 255,255,255
F 255,255,0


1111111
1000001
1000001
100S001
1111111