NO ./path_to_the_north_texture
SO ./path_to_the_south_texture
WE ./path_to_the_west_texture
EA ./path_to_the_east_texture
F 220,12,012
C 225,30,0

111 111 111
101 101 101
1011101 111
100N001
1111111 